// SizeMap Initial position, dirty probability, random seed, map
6 1 0.02 1
O O O O O O O O O O
O - - - - - - - - O
O - O - - O - - - O
O O - - - - - O O O
O - - - - - - - - O
O O - - - - O - - O
O - O - - - - - - O
O - - O - - O O O O
O - - - - - - - - O
O O O O O O O O O O
